                                                                                                                                
                                                                                                                                   XXXXXXXXXXXXXXXXXXXXXXXXXXXXXXXXXXXXXXXXXXXX
               T                                                                                                                                                              X
                                                                                                                                                                              X
                                                                                                                                                                              X
X                                                                       XXXXXXXX                                                                                              X
X                                                                                                                                                                             X                                                                                                                                                                             X
X                                                                                                                                                                             X
X                                                                                                                                                                             X
X                                                                 XX                                             XXXX           XXXXXXXXXXXXXXXXXXXXXXXXXXXXXXXXXXXXXXXXXXXXXXX
X
X                                                                                                                     
X                                                   XXXXXXXXXX                                  XXXXXXX
X                                                     
X
X P
XXXXX                                    XXXXXXXX                                      
XXXXX                                                                                                          XXXXXXX
XXXXX                  M                     
XXXXX                                                                                                     
XXXXX                                       
XXXXX                                       
XXXXXXXXXXXXXXXXXXXXXXXXXXXXXXXXXXXXXXXX                                                XXXXXXXXXXXXXXXXXX